NO                  ./textures/brick.xpm
SO              ./textures/greystone.xpm
                                                                                                                WE ./textures/purplestone.xpm
            EA ./textures/wall.xpm
F 220,100,0
C 225,30,12

       1
     11S1
    1110011
111111110D1111
1111111111111
